40
40
AAAAAAAAAAAAAAAAAAAAAAAAAAAAAAAAAAAAAAAA
AAAAAAAAAAAAAAAAAAAAAAAAAAAAAAAAAAAAAAAA
AA                                    AA
AA                                    AA
AA    AAA              A              AA
AA                     A              AA
AA                     A              AA
AA       A          AAAAAAA           AA
AA       A             A              AA
AA       A             A              AA
AA                     A              AA
AA                                    AA
AA                                    AA
AA                                    AA
AA                                    AA
AA                                    AA
AA                                    AA
AA                                    AA
AA                                    AA
AA                                    AA
AA                                    AA
AA                                    AA
AA                                    AA
AA                                    AA
AA                                    AA
AA                                    AA
AA                                    AA
AA                                    AA
AA                                    AA
AA                                    AA
AA                                    AA
AA                                    AA
AA                                    AA
AA                                    AA
AA                                    AA
AA                                    AA
AA                                    AA
AA                                    AA
AAAAAAAAAAAAAAAAAAAAAAAAAAAAAAAAAAAAAAAA
AAAAAAAAAAAAAAAAAAAAAAAAAAAAAAAAAAAAAAAA